East Asia countries
Гонконг - Hong Kong - HK

Монголия - Mongolia - MN

Тайвань - Taiwan - TW

West Asia countries
Грузия - Georgia - GE
Турция - Turkey - TR
Бахрейн - Bahrain - BH
Сирия - Syria - SY
Израиль - Israel - IL
Палестина - Palestine - PS
Ливан - Lebanon - LB
Объединённые Арабские Эмираты - United Arab Emirates - AE
Ирак - Iraq - IQ
Иордания - Jordan - JO
Катар - Qatar - QA
Армения - Armenia - AM
Оман - Oman - OM
Кувейт - Kuwait - KW
Азербайджан - Azerbaijan - AZ
Саудовская Аравия - Saudi Arabia - SA
Йемен - Yemen - YE

Central Asia countries
Туркмения - Turkmenistan - TM
Таджикистан - Tajikistan - TJ
Казахстан - Kazakhstan - KZ
Узбекистан - Uzbekistan - UZ
Киргизия - Kyrgyzstan - KG

South Asia countries
Бутан - Bhutan - BT
Непал - Nepal - NP
Пакистан - Pakistan - PK
Шри-Ланка - Sri Lanka - LK
Иран - Iran - IR
Бангладеш - Bangladesh - BD
Мальдивы - Maldives - MV
Афганистан - Afghanistan - AF
Индия - India - IN

Southeast Asia countries
Малайзия - Malaysia - MY
Индонезия - Indonesia - ID
Лаос - Laos - LA
Камбоджа - Cambodia - KH
Сингапур - Singapore - SG
Восточный Тимор - Timor-Leste - TL
Мьянма - Myanmar - MM
Вьетнам - Vietnam - VN
Бруней - Brunei - BN
Филиппины - Philippines - PH
Таиланд - Thailand - TH
